NotifNo	Notification
DateLastChange	Time Stamp
NotificationType	Notifictn type
PlanningPlant	Planning plant
Iwerk	Planning plant
IwerkTxt	Name 1
Swerk	MaintPlant
SwerkTxt	Name 1
Qmart	Notifictn type
Aedat	Changed On
Aezeit	Changed at
Auswk	Failure Imp
Auswkt	Effect
Ltrmn	Required End
Qmdat	Notif.date
Mzeit	Notif. Time
Erdat	Created On
Erzeit	Created at
Qmdab	Completn date
Qmzab	Completion time
Bezdt	Reference date
Bezur	ReferenceTime
Aufnr	Order
Priok	Priority
Qmtxt	Description
Ingrp	Planner group
Arbpl	Work center
Arbplwerk	Plt for WorkCtr
ArbplwerkTxt	Name 1
Msaus	Breakdown
Auszt	Breakdown dur.
Ausvn	Malfunct. start
Auztv	Start Malfn (T)
Ausbs	Malfunct.end
Auztb	Malfunction end
Zzcritfail	Unsafe Fail
Innam	PM PlGrp name
Longtxt	Long text for OMPM
Actvtxt	Long text for OMPM
Fecod	Fail mode
FecodTxt	Description
Urcod	Fail Mech
UrcodTxt	Description
Oteil	ObjectPartCode
OteilTxt	Description
Sysstatus	System Status
Userstatus	User Status
Beber	System
Tplnr	Functional loc.
Pltxt	Description
Stort	Location
Abckz	ABC indic.
Eqart	Maint. Concept
EqartTxt	Obj. type text
Rbnr	Catalog profile
Rbnrx	Catalog profile
CritCriticality	Char. Value
ClassificationPlant	Char. Value
CritMainFunction	Char. Value
CritSubFunction	Char. Value
CritRedundancy	Char. Value
CritSafety	Char. Value
CritProduction	Char. Value
CritCost	Char. Value
McConceptNoConcern	Char. Value
McConceptNoPlant	Char. Value
McRepairStrategy	Char. Value
McCriticalSpares	Char. Value
McSparePartRequirement	Char. Value
ControlClass	Char. Value
CritFailHse	Char. Value
CritContainment	Char. Value
CritContainmentCategory	Char. Value
Equnr	Equipment
Eqkt	Description
Mngrps	Code group
Mncods	Activity code
MngrpsTxt	Short text
MncodsTxt	Short text
Abckz	ABC indic.
Iloan	Loc/AccAssmt
DateLastChange	Time Stamp
Artpr	PriorityType
Aedat	Changed on
AbckzTxt	ABC IndicText
Abnum	Call Number
Aenam	Changed by
Aezeit	Changed at
Akknz	Category
Arbpl	Work center
Auart	Order Type
AuartTxt	Short Text
Aufnr	Order
Aufnt	Subnetwork of
Aufpl	Plan no.f.oper.
Aufpt	Plan no.f.oper.
Autyp	Order category
Beber	System
BeberTxt	PersResp.
Bukrs	Company Code
ClassificationPlant	Char. Value
ControlClass	Char. Value
CritContainment	Char. Value
CritContainmentCategory	Char. Value
CritCost	Char. Value
CritCriticality	Char. Value
CritFailHse	Char. Value
CritMainFunction	Char. Value
CritProduction	Char. Value
CritRedundancy	Char. Value
CritSafety	Char. Value
CritSubFunction	Char. Value
Eqfnr	Sort field
Equnr	Equipment
Erdat	Created on
Erfzeit	Time created
Ernam	Entered by
Gaueh	Unit
Gauzt	PlanDowntime/h
Gewrk	Work Center
Gltri	Actual finish
Gltrp	Basic fin. date
Gsber	Business Area
Gstri	Actual start
Gstrp	Bas. Start Date
Idat2	Tech.completion
Idat3	Close
Ilart	MaintActivType
IlartTxt	MAT descriptn
Ingpr	Planner group
IngprTxt	PM PlGrp name
Iphas	Phase
Iwerk	Planning plant
IwerkTxt	Name 1
Kokrs	CO Area
Kostv	Resp. cost cntr
Ktext	Description
Laufn	Last order
Loekz	Deletion flag
Longtext	LONGTEXT
Ltext	Long txt exists
McConceptNoConcern	Char. Value
McConceptNoPlant	Char. Value
McCriticalSpares	Char. Value
McRepairStrategy	Char. Value
McSparePartRequirement	Char. Value
Msgrp	Area
Objnr	Object number
Obknr	Object list
Pdatv	Valid From
Plnal	Group Counter
Plnnr	Group
Plnty	Task List Type
Ppsid	PP work ctr
Prctr	Profit Center
Priok	Priority
PriokTxt	Priority
Proid	WBS Element
Pspel	WBS element
Pverw	Usage
Qmnum	Notification
Refnr	Order
Revnr	Revision
RevnrTxt	RevDescription
Sowrk	Location plant
Stort	Location
StortAufk	Location
StortTxt	Text, 40 Characters Long
Strno	Functional loc.
Swerk	MaintPlant
Tplnr	Functional loc.
User4	Estimated costs
Vaplz	Main WorkCtr
VaplzTxt	Description
Wapos	MaintItem
Warpl	MaintenancePlan
Werks	Plant
Zzfailimpind	FailureImp
Zzwsc1	Sufficient WO-inform
Zzwsc10	Probability number2
Zzwsc11	Probability number3
Zzwsc12	Probability number4
Zzwsc13	Probability number5
Zzwsc14	WSC status
Zzwsc15	WSC status descripti
Zzwsc16	WSC Revision
Zzwsc17	Highest score
Zzwsc2	Workorder requires s
Zzwsc3	Postponement requir
Zzwsc4	Consequence number1
Zzwsc5	Consequence number2
Zzwsc6	Consequence number3
Zzwsc7	Consequence number4
Zzwsc8	Consequence number5
Zzwsc9	Probability number1
Zzwscnr	WSC number
Werks	Plant
Aufpl	Plan no.f.oper.
Objnr	Object number
Aplzl	Counter
Anlzu	SystemCondition
Vornr	Activity
AnlzuTxt	Text
Steus	Control key
Istru	Assembly
Arbid	Object ID
Arbpl	Work center
Ktsch	Std Text Key
KtschTxt	Short text
Ltxa1	Opr. short text
Longtext	LONGTEXT
Sakto	Cost Element
Ekorg	Purchasing Org.
Ekgrp	Purch. Group
Matkl	Material Group
Anzzl	Number
Prznt	Percent
Indet	Calculation key
Larnt	Activity Type
Rueck	Confirmation
Rmzhl	Counter
Banfn	Requisition
Bnfpo	PReq. Item
Ablad	Unloading Point
Dauno	Normal duration
Daune	Norm.duratn un.
Einsa	StartConstraint
Einse	Fin. constraint
Arbei	Work
Arbeh	Unit for work
Ismnw	Actual work
Fsavd	Earl.start date
Fsavz	Earl.start time
Fsedd	EarliestEndDate
Fsedz	Earliest finish
Ssavd	Latest start
Ssavz	Lat. start time
Ssedd	Lat.finish date
Ssedz	Latest fin.time
Isdd	Actual start
Isdz	Act. Start Time
Iedd	Act.finish date
Iedz	Actual finish
Ntanf	Start constr.
Ntanz	StartTimeConstr
Ntend	Finish Constr.
Ntenz	Fin.time constr
Ofmnw	Forecast work
Aufkt	Executn factor
Tplnr	Functional loc.
Equnr	Equipment
Slwid	Field key
Usr00	User field 20
Usr08	User field date
Usr09	User field date
Objnr	Object number
Udate	Date
Stat	Status
Utime	Time
Inact	Status Inact.
Txt04	Status
Txt30	Status
Obknr	Object list
Obzae	Object counters
Equnr	Equipment
Ihnum	Notification
Bautl	Assembly
Iloan	Loc/AccAssmt
Sortf	Sort field
Bearb	ProcessIndic.
Objvw	ObjListUsage
Aufpl	Plan no.f.oper.
Aplzl	Counter
Fbcntr	Counter
Tplnr	Functional loc.
Equnr	Equipment
Feedback	Feedback
FeedbackReason	Feedback reason
Aufnr	Order
Qmnum	Notification
Pltxt	Description
Aedat	Changed on
Aenam	Changed by
Ansdt	Acquistion date
Answt	AcquistnValue
Baujj	ConstructYear
Baumm	ConstructMth
Begru	AuthorizGroup
Brgew	Gross Weight
Datab	Start-up date
Einzl	Single inst.
Einzli	AuthGrp orig.
Ematn	MPN material
Eqart	Maint. Concept
Erdat	Created on
Ernam	Created by
FllbDuty	Logbk Duty
FllbHide	Hide Logbook
Fltyp	FunctLocCat.
Gewei	Weight Unit
Groes	Size/dimens.
Handle	Handle
Herld	ManufCountry
Herst	Manufacturer
Iequi	EquipInstall.
Iequii	EqInst. orig.
IflotSntype	Shift Note Type
IflotSrtype	Report Type
Iloan	Loc/AccAssmt
Ingrp	Planner group
Ingrpi	MPlGroup orig.
Invnr	Inventory no.
Istyp	IS category
Iwerk	Planning plant
Iwerki	PlPlan orig.
Lgwid	Work Center
Lgwidi	WorkCtr origin
Lvorm	SAP Development Reserve: Format CHAR, Length 1
Mapar	ManufPartNo.
Mapari	SAP Development Reserve: Format CHAR, Length 1
Mlang	Primary lang.
Objnr	Object number
PmObjty	Object Type
Posnr	Position
Prems	Premise
Pstae	SAP Development reserve: Format CHAR, length 4
Rbnr	Catalog profile
RbnrI	MntCatlg orig.
Serge	ManufSerialNo.
Stnam	SAP Development Reserve: Format CHAR, Length 12
Submt	ConstType
Submti	ConsType orig.
Tplkz	StrIndicator
Tplma	SupFunctLoc.
Tplnr	Functional loc.
Trpnr	RefLocation
Tsegtp	Template
Typbz	Model number
Waers	Currency
Eqktx	Description
ActChangeAa	Change equipment
Aedat	Changed On
Aenam	Changed by
Ansdt	Acquistion date
Answt	AcquistnValue
Aplkz	Task list
Auldt	Delivery date
Baujj	ConstructYear
Baumm	ConstructMth
Begru	AuthorizGroup
Begrui	AuthGrp orig.
Brgew	Weight
Bstvp	Stock check
Charge	Batch
Cuobj	Int. object no.
Datlwb	Date L.GoodsMvt
Elief	Vendor
Ematn	MPN material
Eqart	Maint. Concept
Eqasp	Primary lang.
Eqber	Note
Eqdat	Date
EqextActive	Append DFPS
EqlbDuty	Logbk Duty
EqlbHide	Hide Logbook
Eqlfn	ConsecNumber
Eqnum	Field
Eqsnr	Number
Eqtyp	EquipCategory
EquiSntype	Shift Note Type
EquiSrtype	Report Type
Equnr	Equipment
Erdat	Created On
Ernam	Created By
Gernr	Serial Number
Gewei	Unit of weight
Groes	Size/dimens.
Gwldt	Begin guarantee
Gwldv	Warranty date
Gwlen	Warranty end
Handle	Handle
Herld	ManufCountry
Herst	Manufacturer
Hzein	Drawing no.
ImrcPoint	Measuring point
Inbdt	Start-up date
Invnr	Inventory no.
IuidType	IUID Type
Kmatn	Config.material
Krfkz	Referenced
Kunde	CurCustomer
Lager	Storage Loc.
Lvorm	SAP Development Reserve: Format CHAR, Length 1
Matnr	Material
Mganr	Master warranty
Objnr	Object number
Revlv	Revision level
SCc	CC
SElse	Other data
SEqbs	EQSI exists
SEqui	Equipment data
Serge	ManufSerialNo.
Sernr	Serial Number
SFhm	ProdRes/Tools
SFleet	FleetObjectData
SIsu	IS-U
SKonfi	Configuration
Sparte	Division
SSale	Sales
SSerial	Serial
Tsegtp	Template
Typbz	Model number
Uii	UII
UiiPlant	Resp. Plant UII
Waers	Currency
Warpl	MaintenancePlan
Wdbwt	ReplValue
Werk	Plant
Arbnr	Work Permit
DateLastChange	Time Stamp
Artyp	Level
Status	Status
StText	Status description
Loekz	Deletion Ind.
Nv1A	Hot work A
Nv1B	Hot work B
Nv1C	Entry
Nv1D	Isolation of saf sys
Nv1E	Pressure testing
Nv1F	Work above sea
Nv1G	Dangerous substances
Nv1H	Radioactive material
Nv1I	Well operation
Nv1J	Explosives
Nv1K	Critical lifting op
Nv1L	Other/critical op
Nv1M	Work on hydrocarbon
Nv1P	Hot work (w/g)
Nv1Q	AWP
Nv1R	Restricted area
Nv1S	Electrical/Mechanica
Nv1T	Dangerous substance
Nv1U	ROP
Nv1V	Blasting
Sn1A	Applicant name
Sn1B	Discipline
Sn1C	Phone
Sn1D	Work description1
Sn1E	Work description2
Sn1F	Work description3
Sn1G	Work description4
Sn1H	Work description5
Sn1HNv2A	Work description6
Sn1HNv2B	Work description7
Sn1HNv2C	Work description8
Sn1HNv2D	Work description9
Sn1I	Equipment/tools1
Sn1J	Equipment/tools2
Werks	Installation
Sn1L	Location/modul
Sn1M	Deck
Sn1N	Tag/line no.
Sn1O	Zone
Sn1Q	Turbine/site
Sn1P	Attachment
Sn1R	Planning phase
Sn1S	Operational phase ri
Sn1T	Access zone
Sja1	Safe job analysis
Sja2	No
Sja3	Requires approval
Aufnr	Order
Vornr	Activity
Isol1	WC Document
DDag	Day
DNatt	Night
DPaga	Ongoing work
DDate1	From Date
DDate2	To Date
DTime1	From hr.
DTime2	To hr.
DForle	Extended to hr.
DLeder	Signature Area/Opera
DSkr	Signature CCR Techn
DOmrtek	Signature Area Techn
Name1	Name
Nv1N	Excavation
Nv1O	Special transport
Language	Language (ISO)
Ext	Indicator: Processing triggered externally
Sn1U	Tag Description
CompanyName	Char80
Nv6A	Offshore vessel
Nv6B	Special lifts
Nv6C	Electrical systems
Nv6D	Oper / SCADA systems
Nv6E	Intrusive work
Nv6F	Dangerous substance
Nv6G	Work above sea
Nv6H	Safety barrier
Nv6I	Confined space
Nv6J	Scaffolding req.
Nv6K	Hot work
Nv6L	Excavation
Nv6M	Pressurized
Nv6N	Diving operation
Nv6O	SIMOPS
Nv7A	Pre-approved Marine
Nv7B	Non-intrusive
Nv7C	Survey activities
Nv7D	AWP + Task file
Nv7E	Access required
Nv7F	Paint work brush
Erdat	Last changed date
Uzeit	Last change time
Counter	ZZARB03 counter
Usnam	Last changed by
StatusChange	Status
Printed	Printed
R1	Release signature1
R2	Release signature2
R3	Release signature3
A1	Activate signature1
A2	Activate signature2
A3	Activate signature3
X1	Extension signature1
X2	Extension signature2
X3	Extension signature3
Lockmet	Lock method
AppWPw	App w/PW
AAvlast	Depressurization
ADrener	Draining/emptying
AElec	HV electrical work
ARengj	Cleaning/gasfreeing
AAvste	Isolation by single
ABlind	Blind/Isolation plan
AMerki	Safety tag/lock
AKoord	Coordinate with oth.
AUtlu	Venting/Extra ventil
AForeb	Prevent release of
ATilta	Measures against rad
AInsp	Inspection of area
ATime	Inspection every XXX
AAnnet	Other
AHydro	Hydrocarbons every
AHyTime	Hydrocarbons every X
AOksygen	Oxygen every
AOkTime	Oxygen every XXX hou
AH2s	H2S every
AH2sTime	H2S every XXX hour
AXxx	    every
AXxxTime	XXX every XXX hour
AUtkLok	Locally
AUtkSkr	CCR
ASystem1	System line1
ASystem2	System line2
AStedomr	Location/Area
AKotil1	Compensating measure
AKotil2	Compensating measure
AGrounding	Grounding
AMech	Mechanical isolation
ATurbine	Turbine key no.
ATurbineNo	Turbine key no.
AVent	Venting/extra ventil
AElekt	Electrical isolation
BGassm	Portable gasdetector
BGmnr	Portable gasdetector
BVerif	Verify mech isolatio
BElekt	Electrical isolation
BElektNr	Equipment no.
BBrannap	Fire Extinguisher
BSveise	Welding machine safe
BKontin	Continuous guard/rad
BDrener	Drains blocked/cover
BAvsper	Barrier/Warning sign
BKoord	Cooperate with CCR/A
BFolge	Follow requirements
BHms	Chemical data sheet
BPros	Procedures/checklist
BRefnr	Ref. No.
BKontr	Control of temporary
BFolgeent	Follow requirements
BSpesielt	Special personal pro
BTilsyk	Measures to avoid wo
BRestrict	Warning signs posted
BLv	LV electrical work
BHv	HV electrical work
BAndrekr	Other requirements/p
BAnlinje1	Other requirements/p
BAnlinje2	Other requirements/p
BAnlinje3	Other requirements/p
BSecArea	Close/secure area
BCds	Chemical data sheet
GLeder	Oper Supervisor Appr
GLeder2	Area Supervisor Appr
GAnnens	Other position Appr
GHmsfun	HSE Function - Appr
GPlattf	Senior Approver
GMerkna	Remarks/requirements
AOmrtek	Area Technician
ASkrtek	CCR Technician
AUtfagp	Executing skilled wo
AXxxG	Gas type
BSpesielt1	Special personal pro
BTilsyk1	Measures to avoid wo
AAnnet1	Other description
ASystem3	System line3
AKotil3	Compensating measure
AAvste1	Isolation by single
AAvste2	Isolation by single
ABlind1	Blind/Isolation plan
ABlind2	Blind/Isolation plan
AMerki1	Safety tag/lock
AMerki2	Safety tag/lock
AUtlu1	Venting/Extra ventil
AUtlu2	Venting/Extra ventil
BKontin1	Continuous guard/rad
BKontin2	Continuous guard/rad
BAvsper1	Barrier/Warning sign
BAvsper2	Barrier/Warning sign
BAvsper3	Barrier/Warning sign
BBarrier	Barrier/Warning sign
BKoord1	Cooperate with CCR/A
BKoord2	Cooperate with CCR/A
BFolge1	Follow requirements
BFolge2	Follow requirements
AAvsteTxt	Char
ABlindTxt	30 Characters
AMerkiTxt	Char20
AUtluTxt	Char
BKontinTxt	Char
BAvsperTxt	Char
BKoordTxt	Char
BFolgeTxt	Char38
ASystem	System
AArea	Area
CCombMat	The area is free fro
CElIsol	Electrical isolator
CSafeDoc	Safety document issu
CElHv	Electrical HV: De-en
CElLv	LV: Isolated from ne
CDiss	Dissipation
CSwe	Safe work environmen
COther	HV electrical work
COther1	Other description
Aufpl	Plan no.f.oper.
Aplzl	Counter
Fbcntr	Counter
ReasonRequired	Reason required
Qmnum	Notification
Qmart	Notifictn type
Aufpl	Plan no.f.oper.
Aplzl	Counter
Fbcntr	Counter
Qmnum	Notification
Qmart	Notifictn type
